#######
#S....#
#..2..#
#..#..#
#....G#
#######
